1111111111
10000C0001
1S00000001
10C00000E1
1111111111