111111111111111111
10000C0000000000S1
10000000E000000001
10C000000000000001
111111111111111111