1111111111111111111
10000100010C0000001
1S0Z0110C00000000E1
1100010000000C00001
1110000000000000001
1C00000000000000001
1111111111111111111