111111111111111111111
100000001000000000001
100000000000011100001
10000000110001E000001
100000000000000000001
1S0000000000000000001
111111111111111111111