111111111111111111111
10C000001C0000000C001
10000C000000011100001
100000001100010000001
10000C000000000000001
1S000C000000000C000C1
111111111111111111111