1111
1S01
1001
1101
1C01
1001
1001
1E11
1111