111111
100S11
10C001
1E0001
1000C1
111111