111111111111111111111
100000000000000000001
10000C000000011100001
10000000000001E000001
100000000100000000001
1S0000000100000C00001
111111111111111111111