11111111111111
1000000C100001
10000000100001
11111000010001
1E000000000001
11111111111111