111111111111111111111
100000001000000000001
100000000000011100001
10000000110001E000001
10000C000000000000001
1S000C000000000C00001
111111111111111111111