111111111111111111111
10000000000000000C001
10000C000000011100001
10000000000001E000001
100000000100000000001
1S0000000100000C000C1
111111111111111111111